 ー	Vowel elongation mark for kana
 ぁ	Hiragana letter small A
 あ	Hiragana letter A
 ぃ	Hiragana letter small I
 い	Hiragana letter I
 ぅ	Hiragana letter small U
 う	Hiragana letter U
 ぇ	Hiragana letter small E
 え	Hiragana letter E
 ぉ	Hiragana letter small O
 お	Hiragana letter O
 か	Hiragana letter KA
 が	Hiragana letter GA
 き	Hiragana letter KI
 ぎ	Hiragana letter GI
 く	Hiragana letter KU
 ぐ	Hiragana letter GU
 け	Hiragana letter KE
 げ	Hiragana letter GE
 こ	Hiragana letter KO
 ご	Hiragana letter GO
 さ	Hiragana letter SA
 ざ	Hiragana letter ZA
 し	Hiragana letter SI
 じ	Hiragana letter ZI
 す	Hiragana letter SU
 ず	Hiragana letter ZU
 せ	Hiragana letter SE
 ぜ	Hiragana letter ZE
 そ	Hiragana letter SO
 ぞ	Hiragana letter ZO
 た	Hiragana letter TA
 だ	Hiragana letter DA
 ち	Hiragana letter TI
 ぢ	Hiragana letter DI
 っ	Hiragana letter small TU
 つ	Hiragana letter TU
 づ	Hiragana letter DU
 て	Hiragana letter TE
 で	Hiragana letter DE
 と	Hiragana letter TO
 ど	Hiragana letter DO
 な	Hiragana letter NA
 に	Hiragana letter NI
 ぬ	Hiragana letter NU
 ね	Hiragana letter NE
 の	Hiragana letter NO
 は	Hiragana letter HA
 ば	Hiragana letter BA
 ぱ	Hiragana letter PA
 ひ	Hiragana letter HI
 び	Hiragana letter BI
 ぴ	Hiragana letter PI
 ふ	Hiragana letter HU
 ぶ	Hiragana letter BU
 ぷ	Hiragana letter PU
 へ	Hiragana letter HE
 べ	Hiragana letter BE
 ぺ	Hiragana letter PE
 ほ	Hiragana letter HO
 ぼ	Hiragana letter BO
 ぽ	Hiragana letter PO
 ま	Hiragana letter MA
 み	Hiragana letter MI
 む	Hiragana letter MU
 め	Hiragana letter ME
 も	Hiragana letter MO
 ゃ	Hiragana letter small YA
 や	Hiragana letter YA
 ゅ	Hiragana letter small YU
 ゆ	Hiragana letter YU
 ょ	Hiragana letter small YO
 よ	Hiragana letter YO
 ら	Hiragana letter RA
 り	Hiragana letter RI
 る	Hiragana letter RU
 れ	Hiragana letter RE
 ろ	Hiragana letter RO
 ゎ	Hiragana letter small WA
 わ	Hiragana letter WA
 ゐ	Hiragana letter WI
 ゑ	Hiragana letter WE
 を	Hiragana letter WO
 ん	Hiragana letter N
 ァ	Katakana letter small A
 ア	Katakana letter A
 ィ	Katakana letter small I
 イ	Katakana letter I
 ゥ	Katakana letter small U
 ウ	Katakana letter U
 ェ	Katakana letter small E
 エ	Katakana letter E
 ォ	Katakana letter small O
 オ	Katakana letter O
 カ	Katakana letter KA
 ガ	Katakana letter GA
 キ	Katakana letter KI
 ギ	Katakana letter GI
 ク	Katakana letter KU
 グ	Katakana letter GU
 ケ	Katakana letter KE
 ゲ	Katakana letter GE
 コ	Katakana letter KO
 ゴ	Katakana letter GO
 サ	Katakana letter SA
 ザ	Katakana letter ZA
 シ	Katakana letter SI
 ジ	Katakana letter ZI
 ス	Katakana letter SU
 ズ	Katakana letter ZU
 セ	Katakana letter SE
 ゼ	Katakana letter ZE
 ソ	Katakana letter SO
 ゾ	Katakana letter ZO
 タ	Katakana letter TA
 ダ	Katakana letter DA
 チ	Katakana letter TI
 ヂ	Katakana letter DI
 ッ	Katakana letter small TU
 ツ	Katakana letter TU
 ヅ	Katakana letter DU
 テ	Katakana letter TE
 デ	Katakana letter DE
 ト	Katakana letter TO
 ド	Katakana letter DO
 ナ	Katakana letter NA
 ニ	Katakana letter NI
 ヌ	Katakana letter NU
 ネ	Katakana letter NE
 ノ	Katakana letter NO
 ハ	Katakana letter HA
 バ	Katakana letter BA
 パ	Katakana letter PA
 ヒ	Katakana letter HI
 ビ	Katakana letter BI
 ピ	Katakana letter PI
 フ	Katakana letter HU
 ブ	Katakana letter BU
 プ	Katakana letter PU
 ヘ	Katakana letter HE
 ベ	Katakana letter BE
 ペ	Katakana letter PE
 ホ	Katakana letter HO
 ボ	Katakana letter BO
 ポ	Katakana letter PO
 マ	Katakana letter MA
 ミ	Katakana letter MI
 ム	Katakana letter MU
 メ	Katakana letter ME
 モ	Katakana letter MO
 ャ	Katakana letter small YA
 ヤ	Katakana letter YA
 ュ	Katakana letter small YU
 ユ	Katakana letter YU
 ョ	Katakana letter small YO
 ヨ	Katakana letter YO
 ラ	Katakana letter RA
 リ	Katakana letter RI
 ル	Katakana letter RU
 レ	Katakana letter RE
 ロ	Katakana letter RO
 ヮ	Katakana letter small WA
 ワ	Katakana letter WA
 ヰ	Katakana letter WI
 ヱ	Katakana letter WE
 ヲ	Katakana letter WO
 ン	Katakana letter N
 ヴ	Katakana letter VU
 ヵ	Katakana letter small KA
 ヶ	Katakana letter small KE
 ゛	Katakana-hiragana voiced sound mark
 ゜	Katakana-hiragana semi-voiced sound mark
